11111111111
1E000C010P1
10111001001
1D1C0001001
10100001001
10001C00001
11111111111