1111111111111
1E01C000000C1
1100010001111
1111111101111
1000C111000C1
10C10000C00P1
1111111111111