111111
1E1CC1
101111
1000P1
111111
