111111
1ECCC1
111111
1000P1
111111