111111
10E00111
100C00P1
11111111